NO ./imgs/wall.xpm
SO ./imgs/wall.xpm
WE ./imgs/wall.xpm
EA ./imgs/wall.xpm

F 220,100,0
C 25,30,0

111111111111
100000000001
100001000001
101000000011
100000S00011
111000000001
100000000001
111111111111